12
20
64
64
....................
....F.K.F...........
....12223......E...E
.....K.........12223
G....13...F....F....
13........122223...K
..................13
.P............F..F..
...........1222223..
.....12223..........
....................
12222222222222222223